===========================================================================================================================================================
|________|_________|_________|_________|_________|_________|_________|_________|_________|_________|_________|_________|_________|_________|_________|____|
|___|_________|_________|_________|_________|_________|_________|_________|_________|_________|_________|_________|_________|_________|_________|_________|
|________|_________|_________|_________|_________|_________|_________|_________|_________|_________|_________|_________|_________|_________|_________|____|
|___|_________|_________|_________|_________|_________|_________|_________|_________|_________|_________|_________|_________|_________|_________|_________|
|________|_________|_________|_________|_________|_________|_________|_________|_________|_________|_________|_________|_________|_________|_________|____|
|___|_________|_________|_________|_________|_________|_________|_________|_________|_________|_________|_________|_________|_________|_________|_________|
|________|_________|_________|_________|_________|_________|_________|_________|_________|_________|_________|_________|_________|_________|_________|____|